##################################################
#                 #                              #
###               ###                            #
###              ###                  ####  #    #
####             ###                 ##        ###
####          ######      ############    ##     #
####            #########                     ####
##   # ## ###      # #  ##                       #
##				#        ##            # ####    #	
###    ### #              ##     #  #  #         #
###          #######			#			 	 #
###S######################################      ##
#                                                #
#                                           ######
#   ######         #######   ###############     #
#       ###      ###    #####          #         #
#         ########                     #         #
####                #            #  #            #
####               ###         # #               #
##################################################
